58672f161bdbe31526fd8384909d4aa22b8fd91da8fce113ea083fbd6022e73e

#define Tiles
0|Assets\Tiles\CastleGround.png
1|Assets\Tiles\CastleWall.png
2|Assets\Tiles\black.png

#define Room
0:2:1 0:2:1 0:2:1 0:2:1 0:2:1 0:2:1 0:2:1 0:2:1 0:2:1 0:2:1 0:2:1 0:2:1 0:2:1 0:2:1 0:2:1
0:2:1 0:2:1 0:2:1 0:2:1 0:2:1 0:2:1 0:2:1 0:2:1 0:2:1 0:2:1 0:2:1 0:2:1 0:2:1 0:2:1 0:2:1
0:2:1 0:2:1 0:2:1 0:2:1 0:2:1 0:2:1 0:2:1 0:2:1 0:2:1 0:2:1 0:2:1 0:2:1 0:2:1 0:2:1 0:2:1
0:2:1 0:2:1 0:2:1 0:2:1 0:2:1 0:2:1 0:2:1 0:2:1 0:2:1 0:2:1 0:2:1 0:2:1 0:2:1 0:2:1 0:2:1
0:2:1 0:2:1 0:2:1 0:2:1 0:2:1 0:2:1 0:2:1 0:2:1 0:2:1 0:2:1 0:2:1 0:2:1 0:2:1 0:2:1 0:2:1
0:2:1 0:2:1 0:2:1 8:1:1 1:1:1 1:1:1 1:1:1 1:1:1 9:1:1 0:2:1 0:2:1 0:2:1 0:2:1 0:2:1 0:2:1
1:1:1 1:1:1 1:1:1 13:1:1 2:1:1 10:1:1 11:1:1 2:1:1 5:1:1 0:2:1 0:2:1 0:2:1 0:2:1 0:2:1 0:2:1
2:1:1 2:1:1 2:1:1 2:1:1 2:1:1 14:1:1 15:1:1 3:1:1 5:1:1 0:2:1 0:2:1 0:2:1 0:2:1 0:2:1 0:2:1
2:1:1 2:1:1 2:1:1 2:1:1 1:0:0 0:0:0 1:0:0 2:0:0 5:1:1 0:2:1 0:2:1 0:2:1 0:2:1 0:2:1 0:2:1
1:0:3 1:0:4 1:0:0 1:0:0 1:0:0 0:0:0 1:0:0 1:0:0 5:1:1 0:2:1 0:2:1 0:2:1 0:2:1 0:2:1 0:2:1
1:1:1 1:1:1 1:1:1 9:1:1 1:0:0 0:0:0 1:0:0 1:0:0 5:1:1 0:2:1 0:2:1 0:2:1 0:2:1 0:2:1 0:2:1
2:1:1 3:1:1 2:1:1 12:1:1 1:1:1 1:1:1 1:1:1 1:1:1 13:1:1 0:2:1 0:2:1 0:2:1 0:2:1 0:2:1 0:2:1
2:1:1 2:1:1 2:1:1 3:1:1 2:1:1 2:1:1 2:1:1 2:1:1 2:1:1 0:2:1 0:2:1 0:2:1 0:2:1 0:2:1 0:2:1
0:2:1 0:2:1 0:2:1 2:1:1 2:1:1 2:1:1 2:1:1 2:1:1 3:1:1 0:2:1 0:2:1 0:2:1 0:2:1 0:2:1 0:2:1
0:2:1 0:2:1 0:2:1 0:2:1 0:2:1 0:2:1 0:2:1 0:2:1 0:2:1 0:2:1 0:2:1 0:2:1 0:2:1 0:2:1 0:2:1