58672f161bdbe31526fd8384909d4aa22b8fd91da8fce113ea083fbd6022e73e




1:1:1 1:1:1 1:1:1 1:1:1 1:1:1 1:1:1 1:1:1 1:1:1 1:1:1 1:1:1 1:1:1 1:1:1 1:1:1
1:1:1 0:1:0 0:1:0 0:1:0 0:1:0 0:1:0 0:1:0 0:1:0 0:1:0 0:1:0 0:1:0 0:1:0 1:1:1
1:1:1 0:1:0 0:1:0 0:1:0 0:1:0 0:1:0 0:1:0 0:1:0 0:1:0 0:1:0 0:1:0 0:1:0 1:1:1
1:1:1 0:1:0 0:1:0 0:1:0 0:1:0 0:1:0 0:1:0 0:1:0 0:1:0 0:1:0 0:1:0 0:1:0 1:1:1
1:1:1 0:1:0 0:1:0 0:1:0 0:1:0 0:1:0 0:1:0 0:1:0 0:1:0 0:1:0 0:1:0 0:1:0 1:1:1
1:1:1 0:1:0 0:1:0 0:1:0 0:1:0 0:1:0 0:1:0 0:1:0 0:1:0 0:1:0 0:1:0 0:1:0 1:1:1
1:1:1 0:1:0 0:1:0 0:1:0 0:1:0 0:1:0 0:1:0 0:1:0 0:1:0 0:1:0 0:1:0 0:1:0 0:1:0
1:1:1 0:1:0 0:1:0 0:1:0 0:1:0 0:1:0 0:1:0 0:1:0 0:1:0 0:1:0 0:1:0 0:1:0 1:1:1
1:1:1 0:1:0 0:1:0 0:1:0 0:1:0 0:1:0 0:1:0 0:1:0 0:1:0 0:1:0 0:1:0 0:1:0 1:1:1
1:1:1 0:1:0 0:1:0 0:1:0 0:1:0 0:1:0 0:1:0 0:1:0 0:1:0 0:1:0 0:1:0 0:1:0 1:1:1
1:1:1 0:1:0 0:1:0 0:1:0 0:1:0 0:1:0 0:1:0 0:1:0 0:1:0 0:1:0 0:1:0 0:1:0 1:1:1
1:1:1 0:1:0 0:1:0 0:1:0 0:1:0 0:1:0 0:1:0 0:1:0 0:1:0 0:1:0 0:1:0 0:1:0 1:1:1
1:1:1 1:1:1 1:1:1 1:1:1 1:1:1 1:1:1 1:1:1 1:1:1 1:1:1 1:1:1 1:1:1 1:1:1 1:1:1
